-1  0  0  0  0  0  0  0  0  0  0  0  0  0  0  0  0  0  0  0  0  0  0  0  0  0  0  0  0  0  0  0  0  0  0  0  0  0 -1 147 
 0  0  0  0  0  0  0  0  0  0  0  0  0  0  0  0  0  0  0  0  0  0  0  0  0  0  0  0  0  0  0  0  0  0  0  0  0  0  0 147
 0  0  0  0  0  0  1  1  0  0  1  1  1  0  1  1  0  0  1  0  1  0  1  1  1  0  1  1  1  0  1  1  1  0  0  0  0  0  0 147
-1  1  0  0  0  0  1  0  1  0  1  0  1  0  1  0  1  0  1  0  0  0  0  0  1  0  1  0  1  0  0  1  0  0  0  0  0  1 -1 147
-1  0  0  0  0  0  1  0  1  0  1  1  1  0  1  1  0  0  1  0  1  0  0  1  0  0  1  0  1  0  0  1  0  0  0  0  0  0 -1 147
 0  0  0  0  0  0  1  0  1  0  1  0  1  0  1  0  1  0  1  0  1  0  1  0  0  0  1  0  1  0  0  1  0  0  0  0  0  0  1 147
 0  0  0  0  0  0  1  1  0  0  1  0  1  0  1  0  1  0  1  0  1  0  1  1  1  0  1  1  1  0  0  1  0  0  0  0  0  0  1 147
-1 -1 -1 -1 -1 -1 -1 -1 -1 -1 -1 -1 -1 -1 -1 -1 -1 -1 -1 -1 -1 -1 -1 -1 -1 -1 -1 -1 -1 -1 -1 -1 -1 -1 -1 -1 -1 -1 -1 147
148
